#######################
#..........#......=...#
#.###.####.#.####.###.#
#o###.####.#.####.###o#
#.....................#
#.###.#.#######.#.###.#
#.....#....#....#.....#
#####.#### # ####.#####
#   #.#         #.#   #
#####.# ### ### #.#####
#    .  #=====#  .    #
#####.# ####### #.#####
#   #.#    %    #.#   #
#####.# ####### #.#####
#..........#..........#
#.###.####.#.####.###.#
#o..#............o...\#
###.#.#.#######.#.#.###
#.....#....#....#.....#
#.########.#.########.#
#.....................#
#######################
